11111111111111111111111111111
1P0000000000000C0000000000001
10010010010010011111001111001
10010010010010010000001001C01
10011110010010010011101001001
10010010010C10010001001001001
10010010011110011111001111001
1C0000000000000000000000000E1
11111111111111111111111111111