111111111111111111111111
11000000000000011P111111
110111111111110100111C11
110000000000010101111011
111110111111010001000011
11C110111000011111011111
110000111111011000000001
11111110C111000011111101
110001101111101111111101
110100001110001111C00001
110111101110111111111101
100111101110110000000101
101100000000110111110001
101101111111110001111111
101100001111111101100001
1011111011000011001C1101
101111100001101110111001
101000111111100010111011
101010111111111010000011
100010000000001011011111
111111110111101011000011
100001110111001011111001
101101110111011000111101
101101110111011110110001
101101110111000110110111
101101100001110110110111
1011000011011100CCC00111
10C1111111E1111111111111
111111111111111111111111