1111111111111111111111
1E000000000000000000E1
1000000000000000000001
1000000000000000000001
1PCCCCCCCCCCCCCCCCCCC1
1000000000000000000001
1E000000000000000000E1
1111111111111111111111