1111111111111111111111111
1E000000000000000000000E1
10C0CCCCCC0CCCCCC0CCCCC01
10C000000C000000C00000C01
10C0CCCCCC0CCCCCC00000C01
10C000000C000000C00000C01
10C0CCCCCC0CCCCCC00000C01
1000000000P00000000000001
1010111111011111101111101
1010000001000000100000101
1010111111011111100000101
1010000001000000100000101
1010111111011111100000101
1E000000000000000000000E1
1111111111111111111111111