111111111111111111111111
100000000000000000000001
100000000000000000000001
10000C00000C00E000000001
10000C000000000000000001
100000000C00000000000001
100C00000000000000000001
100010000C00000000000001
100000000C00000P00000001
111111111111111111111111